 Version: @($) mailsend-go v1.0.1

 mailsend-go [options]
  Where the options are:
  -debug                 - Print debug messages
  -sub subject           - Subject
  -tname                 - name of recipient
  -t to,to..*            - email address/es of the recipient/s. Required
  -list file             - file with list of email addresses. 
                           Syntax is: Name, email_address
  -fname name            - name of sender
  -f address*            - email address of the sender. Required
  -cc cc,cc..            - carbon copy addresses
  -bcc bcc,bcc..         - blind carbon copy addresses
  -smtp host/IP*         - hostname/IP address of the SMTP server. Required
  -port port             - port of SMTP server. Default is 587
  -domain domain         - domain name for SMTP HELO. Default is localhost
  -info                  - Print info about SMTP server
  -ssl                   - SMTP over SSL. Default is StartTLS
  -verifyCert            - Verify Certificate in connection. Default is No
  -ex                    - show examples
  -help                  - show this help
  -q                     - quiet
  -V                     - show version and exit
  auth                   - Auth Command
    -user username*      - username for ESMTP authentication. Required
    -pass password*      - password for EMSPTP authentication. Required
  body                   - body command for attachment for mail body
    -msg msg             - message to show as body 
    -file path           - or path of a text/HTML file
    -mime-type type      - MIME type of the body content. Default is detected
  attach                 - attach command. Repeat for multiple attachments
    -file path*          - path of the attachment. Required
    -name name           - name of the attachment. Default is filename
    -mime-type type      - MIME-Type of the attachment. Default is detected
    -inline              - Set Content-Disposition to "inline". 
                           Default is "attachment"
  header                 - Header Command. Repeat for multiple headers
    -name header         - Header name
    -value value         - Header value

The options with * are required. 

Environment variables:
   SMTP_USER_PASS for auth password (-pass)
    
